111111111

100e0p001
100c00001
111111111