111111111
100100001
101110001
100ec0001
100ccc101
111111101
100c00001
101111111
10cccc0p1
111111111